35 15
0 550
5 5 5 5 5 5 5 5 5 5 5 5 5 5 5 5 5 5 5 5 5 5 5 5 5 5 5 5 5 5 5 5 5 5 5
11 11 11 11 11 11 11 11 11 11 11 11 11 11 11 11 11 11 11 11 11 11 11 11 11 11 11 11 11 11 11 11 11 11 11
10 10 10 10 10 10 10 10 10 10 10 10 10 10 10 10 10 10 10 10 10 10 10 10 10 10 10 10 10 10 10 10 10 10 10
10 10 10 10 10 10 10 10 10 10 10 10 10 10 10 10 10 10 10 10 10 10 10 10 10 10 10 10 10 3 10 10 3 3 10
10 10 10 10 10 10 3 10 10 10 10 10 10 10 3 10 10 3 10 10 10 10 10 3 3 10 10 10 10 10 10 10 10 10 10
10 10 10 10 10 10 10 10 10 10 10 10 10 10 10 10 10 10 10 10 3 3 10 10 10 10 10 10 10 10 10 10 3 10 10
10 3 10 10 3 10 10 10 10 10 10 3 3 3 10 10 10 10 3 10 10 10 10 10 10 10 10 3 10 10 10 10 10 10 10
10 10 10 10 10 10 10 3 10 10 10 10 10 10 10 10 10 10 10 10 10 10 10 10 10 10 10 10 10 10 3 10 10 10 10
10 10 10 10 10 10 10 10 10 3 10 10 10 10 10 10 3 10 10 10 10 10 10 3 10 10 10 10 3 10 10 10 10 10 10
10 10 3 10 10 10 10 10 10 10 10 10 10 10 10 10 10 10 10 10 10 10 10 10 10 10 10 10 10 10 10 10 10 10 3
10 10 10 10 3 10 3 10 10 10 10 3 10 10 10 10 10 10 3 10 3 10 10 10 10 10 10 10 10 10 10 10 10 10 10
10 10 10 10 10 10 10 10 10 10 10 10 10 10 10 10 10 10 10 10 10 10 10 10 10 10 10 10 10 10 10 10 10 10 10
0 0 0 0 4 4 4 0 4 4 0 0 0 0 0 4 4 0 10 10 10 10 10 10 10 10 10 10 10 10 10 10 10 10 10
1 1 1 1 4 4 4 1 4 4 1 1 1 1 1 4 4 1 4 4 0 0 0 0 0 4 4 4 4 0 0 0 0 0 0
1 1 1 1 4 4 4 1 4 4 1 1 1 1 1 4 4 1 4 4 1 1 1 1 1 4 4 4 4 1 1 1 1 1 1
